xxxxxxxxxxxxxxxxxxxxxxxxxxxxxxxxxxxxxxxxxxxxxxxxxxxxxxxxxxxxxxx
xe           v               xx                   v          ex
x                            xx                               x
x  xxxxxxxxxxxxxxxxxxxxx     xx     xxxxxxxxxxxxxxxxxxxxxxx   x
x  xxxxxxxxxxxxxxxxxxxxx     xx     xxxxxxxxxxxxxxxxxxxxxxx   x
x  xx                        xx                         xxx   x
x       xxxxxxx  xxxxxxx     xx     xxxxxx   xxxxxxx          x
x       xxxxxxx  xxxxxxx     xx     xxxxxx   xxxxxxx          x
x  xx                        xx                         xxx   x
x  xx           v            xx            v            xxx   x
x       xxxxxxx  xxxxxxx     xx     xxxxxx   xxxxxxx          x
x       xxxxxxx  xxxxxxx     xx     xxxxxx   xxxxxxx          x
x  xx                        xx                         xxx   x
x  xx                        xx                         xxx   x
x  xx                        xx                         xxx   x
x                            xx                               x
x                                                             x
xxxxxxxxxxxxxxxxxxxx                       xxxxxxxxxxxxxxxxxxxx
xxxxxxxxxxxxxxxxxxxx                       xxxxxxxxxxxxxxxxxxxx
x                 xx                       xx                 x
x                 xx                       xx                 x
x  xxxxx   xxxxx                               xxxxx   xxxxx  x
x  xxxxx   xxxxx                p              xxxxx   xxxxx  x
x                                                             x
x        v                                           v        x
x  xxxxx   xxxxx                               xxxxx   xxxxx  x
x  xxxxx   xxxxx                               xxxxx   xxxxx  x
x                 xx                       xx                 x
x                 xx                       xx                 x
xxxxxxxxxxxxxxxxxxxx                       xxxxxxxxxxxxxxxxxxxx
xxxxxxxxxxxxxxxxxxxx    vvvvvvvv           xxxxxxxxxxxxxxxxxxxx
xxxxxxxxxxxxxxxxxxxx                       xxxxxxxxxxxxxxxxxxxx
                                                               
                                                               
xxxxxxxxxxxxxxxxxxxx                       xxxxxxxxxxxxxxxxxxxx
xxxxxxxxxxxxxxxxxxxx                       xxxxxxxxxxxxxxxxxxxx
xxxxxxxxxxxxxxxxxxxx                       xxxxxxxxxxxxxxxxxxxx
x                 xx                       xx                 x
x                 xx                       xx                 x
x                                                             x
x                                                             x
x                                                             x
x       m                                             m       x
x                                                             x
x                                                             x
x                                                             x
x                 xx                       xx                 x
x                 xx                       xx                 x
xxxxxxxxxxxxxxxxxxxx                       xxxxxxxxxxxxxxxxxxxx
xxxxxxxxxxxxxxxxxxxx                       xxxxxxxxxxxxxxxxxxxx
x                                                             x
x  xxxxxxx   xxxxxxx         xx                xxxxx   xxxx   x
x  xxxxxxx   xxxxxxx         xx                xxxxx   xxxx   x
x                            xx                               x
x                            xx                xxxxx   xxxx   x
x  xxxxxxx   xxxxxxx         xx                xxxxx   xxxx   x
x  xxxxxxx   xxxxxxx         xx                xxxxx   xxxx   x
x                            xx                               x
x                            xx                               x
x  xxxxxxx   xxxxxxx  xxxxx  xx          xxxxxxxxxxxxxxxxxx   x
x  xxxxxxx   xxxxxxx  xxxxx  xx          xxxxxxxxxxxxxxxxxx   x
x                            xx                               x
xe                           xx                              ex
xxxxxxxxxxxxxxxxxxxxxxxxxxxxxxxxxxxxxxxxxxxxxxxxxxxxxxxxxxxxxxx