xxxxxxxxxxxxxxxxxxxxxxxxxxxxxxx v xxxxxxxxxxxxxxxxxxxxxxxxxxxxx
x      v     v      v        xx   xxv     v         xxxxxxxxxxx
x   v    v       v     v     xx v xx   v       v  v xxxxxxxxxxx
x  xxxxxxxxxxxxxxxxxxxxx   v xx v xx     xxxxxxxx   xxxxxxxxxxx
x  xxxxxxxxxxxxxxxxxxxxx     xx   xx   v xxxxxxxx v xxxxxxxxxxx
x                                                             x
x      v                        v           v             v   x
x               v        v   xx   xx                          x
x      v                     xx   xx  v                       x
x                            xx v xx              v           x
x v xxxxxxx     v     xxxxxv xx   xx v xxxx            xxxxx  x
x v xxxxxxx v       v xxxxx  xx   xx   xxxx            xxxxxv x
x                            xx   xx            v             x
xxxxx  v        v                                         v   x
xxxx      v  xxxxxxxx           v     v     xxxxxxx  v        x
xx v m   v   xxxxxxxx                       xxxxxxx           x
xxxx      v                  xx   xx                     v    x
xxxxx  v        v       v    xx   xx     v                    x
x                            xx v xx           v              x
x   xxxxxxx          xxxxxxv xx   xx                  v       x
x v xxxxxxx          xxxxxx  xx   xx v xxxx            xxxxxv x
x               v            xx   xx   xxxx      v     xxxxx  x
x     v                  v   xx v xx     v             v      x
x           xxxxxxxxx                       xxxxxxx           x
x           xxxxxxxxx                       xxxxxxx           x
x                            xx v xx                          x
x      v               v     xx   xx    v       v      v      x
x                            xx   xx                          x
xxxxxxxxxxxx   v   xxxxxxxxxxxx   xxxxxxxxxxx     xxxxxxxxxxxxx
xxxxxxxxxxxx       xxxxxxxxxxxx v xxxxxxxxxxx  v  xxxxxxxxxxxxx
                                                               
v     v      v     v     v   v  p  v   v    v    v    v     v  
                                                               
xxxxxxxxxxxx       xxxxxxxxxxxx v xxxxxxxxxxx  v  xxxxxxxxxxxxx
xxxxxxxxxxxx   v   xxxxxxxxxxxx   xxxxxxxxxxx     xxxxxxxxxxxxx
x   v                  v   v xx   xx   v      v       vvv   xxx
x      xxx     v      xxx    xx   xx     xxx       v       v xx
x   v  xxx            xxx    xx v xx     xxx       v   m   v xx
x      xxx  v      v  xxx  v             xxx       v       v xx
x      xxx            xxx             v  xxx  v       vvv    xx
x   v  xxx     xx  v  xxx    xx v xx     xxx                xxx
x      xxx  v  xx     xxx    xx   xx     xxx            xxxxxxx
x              xx            xx   xx                    xxxxxxx
x       v      xx   v      v xx v xx  v       v               x
x              xx            xx   xx                      v   x
x   v  xxx  v  xx     xxx    xx   xx     xxx     v   xxx      x
x      xxx     xx  v  xxx                xxx         xxx      x
x      xxx            xxx       v        xxx         xxx      x
x   v  xxx     vv     xxx                xxx    xx   xxx      x
x      xxx            xxx  v xx   xx     xxx  v xx   xxx  v   x
x      xxx  v  xx  v  xxx    xx   xx            xx            x
x   v  xxx     xx     xxx    xx v xx      v     xx            x
x              xx            xx   xx  v         xx    v       x
x           v  xx  v       v xx   xx            xx            x
x              xx            xx   xx     xxx  v xx   xxx      x
x   v  xxx     xx     xxx    xx v xx  v  xxx    xx   xxx      x
x      xxx     xx     xxx    xx   xx     xxx         xxx  v   x
x      xxx  v      v  xxx  v xx   xx     xxx    v    xxx      x
x      xxx            xxx    xx v xx  v  xxx         xxx      x
x   v  xxx            xxx                                 v   x
x                          v               v        v         x
x       v   v      v   v     xx v xx                      v   x
x                            xx   xx   v         v            x
xxxxxxxxxxxxxxxxxxxxxxxxxxxxxxx v xxxxxxxxxxxxxxxxxxxxxxxxxxxxx