xxxxxxxxxxxxxxxxxxxxxxxxxxxxxxxxxxxxxxxxxxxxxxxxxxxxxxxxxxxxxxx
xe           v               xx                   v          ex
x                            xx                               x
x  xxxxxxxxxxxxxxxxxxxxx     xx     xxxxxxxxxxxxxxxxxxxxxxx   x
x  xxxxxxxxxxxxxxxxxxxxx     xx     xxxxxxxxxxxxxxxxxxxxxxx   x
x  xx                        xx                         xxx   x
x       xxxxxxx  xxxxxxx     xx     xxxxxx   xxxxxxx          x
x       xxxxxxx  xxxxxxx     xx     xxxxxx   xxxxxxx          x
x  xx                        xx                         xxx   x
x  xx           v            xx            v            xxx   x
x       xxxxxxx  xxxxxxx     xx     xxxxxx   xxxxxxx          x
x       xxxxxxx  xxxxxxx     xx     xxxxxx   xxxxxxx          x
x  xx                        xx                         xxx   x
x  xx                        xx                         xxx   x
x  xx                        xx                         xxx   x
x                            xx                               x
x                                                             x
xxxxxxxxxxxxxxxxxxxx                       xxxxxxxxxxxxxxxxxxxx
xxxxxxxxxxxxxxxxxxxx                       xxxxxxxxxxxxxxxxxxxx
x                 xx                       xx                 x
x                 xx                       xx                 x
x  xxxxx   xxxxx                               xxxxx   xxxxx  x
x  xxxxx   xxxxx                p              xxxxx   xxxxx  x
x                                                             x
x        v                                           v        x
x  xxxxx   xxxxx                               xxxxx   xxxxx  x
x  xxxxx   xxxxx                               xxxxx   xxxxx  x
x                 xx                       xx                 x
x                 xx                       xx                 x
xxxxxxxxxxxxxxxxxxxx                       xxxxxxxxxxxxxxxxxxxx
xxxxxxxxxxxxxxxxxxxx                       xxxxxxxxxxxxxxxxxxxx
xxxxxxxxxxxxxxxxxxxx                       xxxxxxxxxxxxxxxxxxxx
                                                               
                                                               
xxxxxxxxxxxxxxxxxxxx                        xxxxxxxxxxxxxxxxxxx
xxxxxxxxxxxxxxxxxxxx                        xxxxxxxxxxxxxxxxxxx
xxxxxxxxxxxxxxxxxxxx                        xxxxxxxxxxxxxxxxxxx
x                 xx                        xx                x
x                 xx                        xx                x
x                 xx                        xx                x
x                 xx                        xx                x
x                 xx                        xx                x
x                 xx                        xx                x
x                 xx                        xx                x
x                 xx                        xx                x
x                 xx                        xx                x
x                 xx                        xx                x
x                 xx                        xx                x
xxxxxxxxxxxxxxxxxxxx                        xxxxxxxxxxxxxxxxxxx
xxxxxxxxxxxxxxxxxxxx                        xxxxxxxxxxxxxxxxxxx
x                                                             x
x  xxxxxxx                   xx                xxxxx   xxxx   x
x  xxxxxxx                   xx                xxxxx   xxxx   x
x                            xx                               x
x  x                         xx                xxxxx   xxxx   x
x  x                         xx                xxxxx   xxxx   x
x  x                         xx                xxxxx   xxxx   x
x                            xx                               x
x                            xx                               x
x  xxxxxxxxxxxxxxxxx         xx          xxxxxxxxxxxxxxxxxx   x
x  xxxxxxxxxxxxxxxxx         xx          xxxxxxxxxxxxxxxxxx   x
x                            xx                               x
xe                           xx                              ex
xxxxxxxxxxxxxxxxxxxxxxxxxxxxxxxxxxxxxxxxxxxxxxxxxxxxxxxxxxxxxxx