xxxxxxxxxxxxxxxxxxxxxxxxxxxxxxxxxxxxxxxxxxxxxxxxxxxxxxxxxxxxxxx
x                                                             x
x                                                             x
x                                                             x
x                                                             x
x                                                             x
x                                                             x
x                                                             x
x                 xxxxxxxxxxxxxxxxxxx                         x
x                 x        e        x                         x
x                 x                 x                         x
x                 x                 x                         x
x                 x                 x                         x
x                 x                 x                         x
x                 x                 x                         x
x                 x                 x                         x
x                 x                 x                         x
x                 x   e             x                         x
xxxxxxxxxxxxxxxxxxx                 x xxxxxxxxxxxxxxxx        x
x                                                    x        x
x                                   e                x        x
x                     vxxxxxxxxxxxxxxx               x        x
x                      xx     v  p   x               x        x
x                     vxx  xxxxxxxxxxx               x        x
x                      xx  xx                        x        x
x                      xx vxx       v                x        x
x                      xx  xx                        x        x
x                  m  vvvv xx                        x        x
x                  xxxxxxxxxx                        x        x
x                                       e            x        x
x                                                    x        x
x                  xxxxxxxxxxxxxxxxxxxxxxxxxxxxxxxxxxx        x
x                              e                              x
x                                                             x
x                                                             x
x                                                             x
x                                                             x
x                                                             x
x                                                             x
x                                                             x
x                                                             x
x                                                             x
x                                                             x
x                                                             x
x                                                             x
x                                                             x
x                                                             x
x                                                             x
x                                                             x
x                                                             x
x                                                             x
x                                                             x
x                                                             x
x                                                             x
x                                                             x
x                                                             x
x                                                             x
x                                                             x
x                                                             x
x                                                             x
x                                                             x
x                                                             x
x                                                             x
xxxxxxxxxxxxxxxxxxxxxxxxxxxxxxxxxxxxxxxxxxxxxxxxxxxxxxxxxxxxxxx
