xxxxxxxxxxxxxxxxxxxxxxxxxxxxxxxxxxxxxxxxxxxxxxxxxxxxxxxxxxxxxxx
x                                                             x
x                                                             x
x                                                             x
x                                                             x
x                                                             x
x                                                             x
x                                                             x
x                                                             x
x                          e                                  x
x                                                             x
x                                                             x
x                                                             x
x                                                             x
x                                                             x
x             e                                               x
x                                  e                          x
x                                                             x
x                                                             x
x                                       v                     x
x                             xxxxx                           x
x                             x   x                           x
x                             x p x    v                      x
x                             x   x                           x
x                             xxxxx                           x
x                                   v                         x
x                                                             x
x                                                             x
x                   e                                         x
x                                                             x
x                                                             x
x                                                             x
x                              e                              x
x                                                             x
x                                                             x
x                                                             x
x                                                             x
x                                                             x
x                                                             x
x                                                             x
x                                                             x
x                                                             x
x                                                             x
x                                                             x
x                                                             x
x                                                             x
x                                                             x
x                                                             x
x                                                             x
x                                                             x
x                                                             x
x                                                             x
x                                                             x
x                                                             x
x                                                             x
x                                                             x
x                                                             x
x                                                             x
x                                                             x
x                                                             x
x                                                             x
x                                                             x
x                                                             x
xxxxxxxxxxxxxxxxxxxxxxxxxxxxxxxxxxxxxxxxxxxxxxxxxxxxxxxxxxxxxxx