xxxxxxxxxxxxxxxxxxxxxxxxxxxxxxxxxxxxxxxxxxxxxxxxxxxxxxxxxxxxxxx
x            v                                      xxxxxxxxxxx
x                                                   xxxxxxxxxxx
x                                                   xxxxxxxxxxx
x                                                             x
x                                                             x
x                                                             x
x                                                             x
x                                                             x
x                          e                                  x
x                                                             x
x                                                             x
x                                                             x
x                                                             x
x                                                             x
x                                                             x
x                                                             x
x                     e                                       x
x                                                             x
x                                                    x        x
x                                   e                x        x
x                     v                              x        x
x                             v  p   x               x        x
x                     v    xxxxxxxxxxx               x        x
x                                                    x        x
x                         v         v                x        x
x                                                    x        x
x                  m  vvvv                           x        x
x                                                    x        x
x                                       e            x        x
x                                                    x        x
x                  xxxxxxxxxxxxxxxxxxxxxxxxxxxxxxxxxxx        x
x                              e                              x
x                                                             x
x                                                             x
x                                                             x
x                                                             x
x                                                             x
x                                                             x
x                                                             x
x                                                             x
x                                                             x
x                                                             x
x                                                             x
x                                                             x
x                                                             x
x                                                             x
x                                                             x
x                                                             x
x                                                             x
x                                                             x
x                                                             x
x                                                             x
x                                                             x
x                                                             x
x                                                             x
x                                                             x
x                                                             x
x                                                             x
x                                                             x
x                                                             x
x                                                             x
x                                                             x
xxxxxxxxxxxxxxxxxxxxxxxxxxxxxxxxxxxxxxxxxxxxxxxxxxxxxxxxxxxxxxx
