xxxxxxxxxxxxxxxxxxxxxxxxxxxxxxxxxxxxxxxxxxxxxxxxxxxxxxxxxxxxxxx
x                                                             x
x                                                             x
x                                                             x
x                                                             x
x                                                             x
x                                                             x
x                                                             x
x                 xxxxxxxxxxxxxxxxxxx                         x
x                 x        e        x                         x
x                 x                 x                         x
x                 x                 x                         x
x                 x                 x                         x
x                 x                 x                         x
x                 x                 x                         x
x                 x                 x                         x
x                 x                 x                         x
x                 x   e             x                         x
xxxxxxxxxxxxxxxxxxx                 x xxxxxxxxxxxxxxxx        x
x                                                    x        x
x                                   e                x        x
x                     vxxxxxxxxxxxxxxx               x        x
x                  xx  xxx    v  p   x               x        x
x                  xx vxxx xxxxxxxxxxx               x        x
x                  xx  xxx xx                        x        x
x                  xx  xxxvxx       v                x        x
x                  xx  xxx xx                        x        x
x                  xx      xx                        x        x
x                  xxxxxxxxxx                        x        x
x                                       e            x        x
x                                                    x        x
x                  xxxxxxxxxxxxxxxxxxxxxxxxxxxxxxxxxxx        x
x                              e                              x
x                                                             x
x                                                             x
x                                                             x
x                                                             x
x                                                             x
x                                                             x
x                                                             x
x                                                             x
x                                                             x
x                                                             x
x                                                             x
x                                                             x
x                                                             x
x                                                             x
x                                                             x
x                                                             x
x                                                             x
x                                                             x
x                                                             x
x                                                             x
x                                                             x
x                                                             x
x                                                             x
x                                                             x
x                                                             x
x                                                             x
x                                                             x
x                                                             x
x                                                             x
x                                                             x
xxxxxxxxxxxxxxxxxxxxxxxxxxxxxxxxxxxxxxxxxxxxxxxxxxxxxxxxxxxxxxx
